a121211b160b21161b1111111
1b1111211121b2112b611101b
116a11a11611a1116a1106116
b1111102111a11211161ba661
b26b111a12b12160811511222
1261a2015512ba111b1226292
a2bb11b41162bb11302111b16
55193221105a2a61611181141
1464412930a6111a31b716232
9529561355122a4390963336a
